148
8
22	4	0	0	0	0	0	0	0	0	0	0	0	0	0	0	0	0	0	0	0	0	0	0	0	0	0	0	0	0	0	0	0	0	0	0	0	0	0	0	0	0	0	0	0	0	0	0	0	0	0	0	0	0	0	0	0	0	0	0	0	0	0	0	0	0	0	0	0	0	0	0	0	0	0	0	0	0	0	0	0	0	0	0	0	0	0	0	0	0	0	0	0	0	0	0	0	3	22	22	22	22	22	22	22	22	22	22	22	22	22	22	22	22	22	22	22	22	22	4	0	0	0	0	0	0	0	0	0	0	0	3	22	22	22	22	22	22	22	22	22	22	22	22	22	22	22	22
22	4	0	0	0	0	0	0	0	0	0	0	0	0	0	0	0	0	0	0	0	0	0	0	0	0	0	0	0	0	0	0	0	0	0	0	0	0	0	0	0	0	0	0	0	0	0	0	0	0	0	0	0	0	0	0	0	0	0	0	0	0	0	0	0	0	0	0	0	0	0	0	0	0	0	0	0	0	0	0	0	0	0	0	0	0	0	0	0	0	0	0	0	0	0	0	0	3	22	22	22	22	22	22	22	22	22	22	22	22	22	22	22	22	22	22	22	22	22	4	0	0	0	0	0	0	0	0	0	0	0	0	18	22	22	22	22	22	19	17	17	17	17	17	17	17	18	22
22	4	0	0	0	0	0	0	0	0	0	0	0	0	0	0	0	0	0	0	0	0	0	0	0	0	0	0	0	0	0	0	0	0	0	0	23	25	0	0	0	0	0	23	25	0	0	0	0	0	23	25	0	0	0	0	0	0	0	0	0	0	0	0	0	0	0	0	0	0	0	0	0	0	0	0	0	0	0	0	0	0	0	0	0	0	0	0	0	0	0	0	0	0	0	0	0	3	22	22	22	22	22	22	22	22	22	22	22	22	22	22	22	22	22	22	22	22	19	0	0	0	0	0	0	1	21	21	2	0	0	0	0	18	22	22	22	22	4	0	0	0	0	0	0	0	3	22
22	4	0	0	0	0	0	0	0	0	0	0	0	0	0	0	0	0	0	0	0	0	0	0	0	23	25	0	0	0	23	25	0	0	0	0	0	0	0	0	0	0	0	0	0	0	0	0	0	0	0	0	0	0	0	0	0	23	24	24	24	25	0	0	0	0	0	0	0	0	0	0	0	0	0	0	0	0	0	0	0	0	0	0	0	0	1	21	2	0	0	0	0	1	21	2	0	3	22	22	22	22	22	22	22	22	22	22	22	22	22	22	22	22	22	22	19	17	0	0	0	0	0	0	0	3	22	22	4	0	0	0	0	0	18	22	22	22	4	0	0	0	0	0	0	0	3	22
22	4	0	0	0	0	0	0	0	0	0	0	0	0	0	0	0	0	0	23	25	0	0	0	0	0	0	0	0	0	0	0	0	0	0	0	0	0	0	0	0	0	0	0	0	0	0	0	0	0	0	0	0	0	0	0	0	0	0	0	0	0	0	0	0	0	0	0	0	0	0	0	0	0	0	0	0	0	0	0	1	21	2	0	0	0	3	22	4	0	0	0	0	3	22	4	0	3	22	22	22	22	22	22	22	22	19	17	17	17	17	17	17	17	17	17	0	0	0	0	0	0	0	1	21	21	6	22	4	0	0	0	0	0	0	18	22	22	4	0	0	0	0	0	0	0	3	22
22	4	0	0	0	0	0	0	0	0	0	0	0	0	0	0	0	0	0	0	0	0	0	0	0	0	0	0	0	0	0	0	0	0	23	25	0	0	0	0	0	0	0	0	0	0	0	0	0	0	0	0	0	0	0	0	0	0	0	0	0	0	0	0	0	0	0	0	0	0	0	0	0	0	0	0	0	0	0	0	3	22	4	0	0	0	3	22	4	0	0	0	0	3	22	4	0	0	17	17	17	17	17	17	17	17	0	0	0	0	0	0	0	0	0	0	0	0	0	0	0	0	0	3	22	22	22	22	4	0	0	0	0	0	0	0	17	17	0	0	0	0	0	0	0	0	3	22
22	4	9	0	10	0	0	0	0	11	0	0	0	0	23	24	25	0	0	0	0	0	0	0	0	0	0	0	0	23	24	24	25	0	0	0	0	0	23	24	25	0	0	0	0	23	25	0	0	23	25	0	0	0	0	0	0	0	0	0	0	0	0	0	0	0	0	0	0	0	0	0	0	0	0	1	21	2	0	0	3	22	4	0	0	0	3	22	4	0	0	0	0	3	22	4	0	0	0	0	0	1	21	21	21	21	2	0	0	1	21	2	0	0	1	21	2	0	1	21	2	0	0	3	22	22	22	22	4	0	0	0	0	0	0	0	0	0	0	0	10	11	0	0	9	0	3	22
5	21	21	21	21	21	21	21	21	21	2	0	0	0	0	0	0	0	0	0	0	0	0	0	0	0	0	0	0	0	0	0	0	0	0	0	0	0	0	0	0	0	0	0	0	0	0	0	0	0	0	0	0	0	0	0	0	0	0	0	0	0	0	0	0	0	0	23	24	24	24	25	0	0	0	3	22	4	0	0	3	22	4	0	0	0	3	22	4	0	0	0	0	3	5	21	21	21	21	21	21	21	6	22	22	5	21	21	21	21	7	21	21	21	21	7	21	21	21	7	21	21	21	21	22	22	22	22	21	21	21	21	21	21	21	21	21	21	21	21	21	21	21	21	21	21	21	6
